Chalti Hai Kya 9 Se 12	Judwaa 2
Mere Rashke Qamar	Baadshaho
Bandook Meri Laila	A Gentleman
Golmaal Title Track	Golmaal Again !!!
Bom Diggy	Bom Diggy
Aa To Sahii	Judwaa 2
Ban Ja Rani	Tumhari Sulu
Oonchi Hai Building 2.0	Judwaa 2
Tere Mere	Tere Mere
Nazm Nazm	Bareilly Ki Barfi
Jogi	Shaadi Mein Zaroor Aana
Maine Tujhko Dekha	Golmaal Again !!!
Disco Disco	A Gentleman
Hawa Hawa	Mubarakan
Socha Hai	Baadshaho
Sweety Tera Drama	Bareilly Ki Barfi
Hawayein	Jab Harry Met Sejal
Main Tera Boyfriend	Raabta
Ittefaq Se Raat Baaki	Ittefaq
Mercy	Mercy
Aaj Zid	Aksar 2
Sexy Baliye	Secret Superstar
Lag Ja Gale	Bhoomi
Galti Se Mistake	Jagga Jasoos
Cheez Badi	Machine
Phir Bhi Tumko Chaahunga	Half Girlfriend
Piya More	Baadshaho
Suit Suit	Hindi Medium
Jaana Ve	Aksar 2
Zaalima	Raees
