Swag Se Swagat	Tiger Zinda Hai
Dil Diyan Gallan	Tiger Zinda Hai
Pallo Latke	Shaadi Mein Zaroor Aana
Ban Ja Rani	Tumhari Sulu
Aa To Sahii	Judwaa 2
Tera Zikr	Tera Zikr
Bom Diggy	Bom Diggy
Mehbooba	Fukrey Returns
Tere Mere	Tere Mere
Mere Rashke Qamar	Baadshaho
Ghoomar	Padmavati
Chalti Hai Kya 9 Se 12	Judwaa 2
Paintra	Mukkabaaz
Maine Tujhko Dekha	Golmaal Again !!!
Nazm Nazm	Bareilly Ki Barfi
Hawayein	Jab Harry Met Sejal
Jogi	Shaadi Mein Zaroor Aana
Bandook Meri Laila	A Gentleman
Lift Teri Bandh Hai	Judwaa 2
Hawa Hawai 2.0	Tumhari Sulu
Socha Hai	Baadshaho
Sweety Tera Drama	Bareilly Ki Barfi
Hawa Hawa	Mubarakan
Main Tera Boyfriend	Raabta
Suit Suit	Hindi Medium
Ek Dil Ek Jaan	Padmavati
Cheez Badi	Machine
Aaj Zid	Aksar 2
Mercy	Mercy
Golmaal Title Track	Golmaal Again !!!
