Mere Rashke Qamar	Baadshaho
Bom Diggy	Bom Diggy
Chalti Hai Kya 9 Se 12	Judwaa 2
Hawayein	Jab Harry Met Sejal
Sweety Tera Drama	Bareilly Ki Barfi
Bandook Meri Laila	A Gentleman
Hawa Hawa	Mubarakan
Disco Disco	A Gentleman
Galti Se Mistake	Jagga Jasoos
Main Tera Boyfriend	Raabta
Nazm Nazm	Bareilly Ki Barfi
Mercy	Mercy
Socha Hai	Baadshaho
Radha	Jab Harry Met Sejal
Lag Ja Gale	Bhoomi
Aaj Zid	Aksar 2
Ding Dang	Munna Michael
Cheez Badi	Machine
Phir Bhi Tumko Chaahunga	Half Girlfriend
Tere Mere	Chef
Oonchi Hai Building 2.0	Judwaa 2
Ik Vaari Aa	Raabta
Piya More	Baadshaho
Suit Suit	Hindi Medium
Aa To Sahii	Judwaa 2
Rocket Saiyyan	Shubh Mangal Saavdhan
Humsafar	Badrinath Ki Dulhania
Zaalima	Raees
Kaun Tujhe	M.S. Dhoni - The Untold Story
Bulleya	Ae Dil Hai Mushkil
